5
6 2 -1
6 1 -5
3 1 -5
5 1 -2
4 2 -7
xxxxxxxxxxxxxxxxxxxxxxxxxxxxxxxxxxxxxxxxxxxxxxxxxxxxxxxxxxxxxxxxxxxxxxxxxxxxx
x                                                                           x
x                                                                           x
x+                                xxxxxxxxxxxxxxxx                          x
  +     xxxxxx                                   x                          x
x+      x     x                                  x                          x
x++     x      x                                 x                          x
x       x       x                                x                          x
x xxxxxxxx       x                               x                          x
x       x         x                              x                          x
xxxxxxxxx          x                             x                          x
S       x           x                            x                          x
x       x            x                           x                          x
x       xxxxxxxxxxxxxxx                          x                          x
x                                                x                          x
x                                                x                          x
xxxxxxxxxxxxxxxxxxxxxxxxxxxxxxxxxxxxxxxxxxxxxxxxxxxxxxxxxxxxxxxxxxxxxxxxxxxxx